#########################
#_______________________#
#_______________________#
#_______________________#
#_______________________#
#_______________________#
#_______________________#
#_______________________#
#_______________________#
#########################